###################
#C# C         C # #
# # #####C##### # #
#   C         C   #
# ##### ### ##### #
#  C    # #       #
# ### # ### # ### #
# # # #     # # # #
#C###C# ### # ### #
#     # # # #     #
# ##### ### ##### #
#     TBBH        #
###################
