########################
#         O#############
#   P   ################
#          #############
#######    #############
#  O ##    #############
#    ##    #############
#          #############
#       XX #############
#       #  #############
########################
########################
########################
########################
########################
########################
########################
