############
#         O
#   P   ##
#          #
#######    #
#  O ##    #
#    ##    #
#          #
#       XX #
#       #  #
############