   #####   
####   #   
#  #X  ####
# XX      #
#P  #X X# #
### #   # #
 #  #####s#
 #  OOOOO #
 ##########