_________________________________________________________________________________________________________________                   
_______________________/\\\\____________/\\\\_____________________________________________________________________                  
_______________________\/\\\\\\________/\\\\\\_____________________________________________________________________                 
________________________\/\\\//\\\____/\\\//\\\____/\\\__/\\\_______________________________________________________                
_________________________\/\\\\///\\\/\\\/_\/\\\___\//\\\/\\\________________________________________________________               
__________________________\/\\\__\///\\\/___\/\\\____\//\\\\\_________________________________________________________              
___________________________\/\\\____\///_____\/\\\_____\//\\\__________________________________________________________             
____________________________\/\\\_____________\/\\\__/\\_/\\\___________________________________________________________            
_____________________________\/\\\_____________\/\\\_\//\\\\/____________________________________________________________           
______________________________\///______________\///___\////______________________________________________________________          
__/\\\\\\\\\\\______________________________________________/\\\___________________________________________________/\\\____         
_/\\\/////////\\\________________/\\\_______________________\/\\\_________________________________________________/\\\\\\\__        
_\//\\\______\///________________\/\\\_______________________\/\\\________________________________________________/\\\\\\\\\_       
___\////\\\_____________/\\\\\____\/\\\\\\\\________/\\\\\____\/\\\_________/\\\\\\\\\_____/\\/\\\\\\_____________\//\\\\\\\__      
_______\////\\\________/\\\///\\\__\/\\\////\\\____/\\\///\\\__\/\\\\\\\\\__\////////\\\___\/\\\////\\\_____________\//\\\\\___     
___________\////\\\____/\\\__\//\\\_\/\\\\\\\\/____/\\\__\//\\\_\/\\\////\\\___/\\\\\\\\\\__\/\\\__\//\\\_____________\//\\\____    
_____/\\\______\//\\\__\//\\\__/\\\__\/\\\///\\\___\//\\\__/\\\__\/\\\__\/\\\__/\\\/////\\\__\/\\\___\/\\\______________\///_____   
_____\///\\\\\\\\\\\/____\///\\\\\/___\/\\\_\///\\\__\///\\\\\/___\/\\\\\\\\\__\//\\\\\\\\/\\_\/\\\___\/\\\_______________/\\\____  
________\///////////________\/////_____\///____\///_____\/////_____\/////////____\////////\//__\///____\///_______________\///_____ 
____________________________________________________________________________________________________________________________________